12
12
88
000000000000
000000000000
666666666666
555555555555
00a0a00a0a00
444444444444
00a0a00a0a00
00a0a00a0a00
444444444444
00a0a00a0a00
444444444444
555555555555
STOP