10
12
88
111111111111
333333333333
00a0a00a0a00
333333333333
111111111111
222222222222
00d0d00d0d00
00a0a00a0a00
00i0i00i0i00
111111111111
STOP