0
12
12
106
0n0n0n0n0n0n
m0m0m0m0m0m0
666666666666
555555555555
00a0a00a0a00
444444444444
0na0a0na0a0n
0na0a0na0a0n
444444444444
00a0a00a0a00
444444444444
55d555555d55
STOP