0
12
12
94
0m000m000m00
m0m0m0m0m0m0
000m000m000m
333333333333
00a0a00a0a00
333333333333
111111111111
222222222222
30i0i00i0i03
30a0a00a0a03
30i0i00i0i03
111111111111
STOP