14
12
96
000000000000
000000000000
000000000000
000000000000
d0a0a00a0a0d
d0a0a00a0a0d
d0a0a00a0a0d
999999999999
999998899999
888888888888
777777777777
999999999999
777777777777
d0a0a00a0a0d
STOP