1
14
12
108
000000000000
000000000000
0nnn0000nnn0
0mmm0000mmm0
40a0a00a0a04
40a0a00a0a04
40a0a00a0a04
999999999999
999998899999
888888888888
777777777777
999999999999
777777777777
d0a0a00a0a0d
STOP